"aa" = (/turf/open/space/basic,/area/space)
"ab" = (/turf/closed/wall/mineral/titanium,/area/shuttle)
"ac" = (/obj/structure/sign/warning/vacuum/external,/turf/closed/wall/mineral/titanium,/area/shuttle)
"ad" = (/obj/machinery/door/airlock/command,/obj/docking_port/mobile{dir = 3; id = "NTExplorer"},/turf/open/floor/plasteel/blue,/area/shuttle)
"ae" = (/obj/machinery/door/airlock/command,/turf/open/floor/plasteel/blue,/area/shuttle)
"af" = (/turf/open/floor/plasteel/white,/area/shuttle)
"ag" = (/obj/effect/turf_decal/stripes/line{dir = 1},/turf/open/floor/plasteel/blue,/area/shuttle)
"ah" = (/obj/machinery/light{dir = 4},/turf/open/floor/plasteel/white,/area/shuttle)
"ai" = (/obj/machinery/suit_storage_unit/standard_unit,/turf/open/floor/plasteel,/area/shuttle)
"aj" = (/obj/effect/turf_decal/bot,/obj/machinery/light{dir = 1},/obj/machinery/suit_storage_unit/standard_unit,/turf/open/floor/plasteel,/area/shuttle)
"ak" = (/obj/effect/turf_decal/bot,/obj/item/tank/jetpack/oxygen,/turf/open/floor/plasteel,/area/shuttle)
"al" = (/obj/structure/extinguisher_cabinet,/turf/closed/wall/mineral/titanium,/area/shuttle)
"am" = (/turf/open/floor/plasteel/blue,/area/shuttle)
"an" = (/obj/machinery/door/airlock/shuttle,/turf/open/floor/plasteel/blue,/area/shuttle)
"ao" = (/obj/effect/turf_decal/delivery,/turf/open/floor/plasteel,/area/shuttle)
"ap" = (/obj/machinery/navbeacon{codes_txt = "patrol;next_patrol=CHW"; location = "Lockers"},/turf/open/floor/plasteel,/area/shuttle)
"aq" = (/obj/effect/turf_decal/bot,/obj/vehicle/ridden/atv{dir = 6},/turf/open/floor/plasteel,/area/shuttle)
"ar" = (/obj/machinery/navbeacon,/turf/open/floor/plasteel/white,/area/shuttle)
"as" = (/obj/machinery/door/airlock/shuttle,/turf/open/floor/plasteel/white,/area/shuttle)
"at" = (/obj/structure/sign/poster/official/safety_internals,/turf/closed/wall/mineral/titanium,/area/shuttle)
"au" = (/obj/effect/turf_decal/bot,/obj/machinery/light,/obj/machinery/suit_storage_unit/standard_unit,/turf/open/floor/plasteel,/area/shuttle)
"av" = (/obj/machinery/light{dir = 8},/turf/open/floor/plasteel/white,/area/shuttle)
"aw" = (/obj/machinery/light{dir = 1},/obj/structure/closet/crate/bin,/turf/open/floor/plasteel/white,/area/shuttle)
"ax" = (/obj/structure/sign/warning/nosmoking/circle,/turf/closed/wall/mineral/titanium,/area/shuttle)
"ay" = (/obj/structure/table,/obj/machinery/microwave,/turf/open/floor/plasteel/white,/area/shuttle)
"az" = (/obj/structure/closet/secure_closet/freezer/meat,/turf/open/floor/plasteel/white,/area/shuttle)
"aA" = (/obj/machinery/light{dir = 8},/turf/open/floor/plasteel/blue,/area/shuttle)
"aB" = (/obj/machinery/washing_machine{dir = 4},/turf/open/floor/plasteel/white,/area/shuttle)
"aC" = (/obj/machinery/light{dir = 1},/turf/open/floor/plasteel/white,/area/shuttle)
"aD" = (/obj/structure/weightlifter,/turf/open/floor/plasteel/white,/area/shuttle)
"aE" = (/obj/machinery/door/window/westleft,/turf/open/floor/plasteel/white,/area/shuttle)
"aF" = (/obj/structure/toilet{dir = 8},/obj/machinery/light{dir = 1},/turf/open/floor/plasteel/white,/area/shuttle)
"aG" = (/obj/structure/table,/obj/item/storage/box/evidence,/obj/item/camera,/turf/open/floor/plasteel/white,/area/shuttle)
"aH" = (/obj/structure/table,/obj/item/clipboard,/obj/item/folder/white,/turf/open/floor/plasteel/white,/area/shuttle)
"aI" = (/obj/structure/table,/obj/item/camera_film,/obj/item/paper_bin,/obj/item/pen,/turf/open/floor/plasteel/white,/area/shuttle)
"aJ" = (/obj/structure/filingcabinet/chestdrawer,/turf/open/floor/plasteel/white,/area/shuttle)
"aK" = (/obj/structure/tank_dispenser,/turf/open/floor/plasteel,/area/shuttle)
"aL" = (/obj/effect/turf_decal/bot,/obj/structure/reagent_dispensers/fueltank,/turf/open/floor/plasteel,/area/shuttle)
"aM" = (/obj/effect/turf_decal/bot,/turf/open/floor/plasteel,/area/shuttle)
"aN" = (/obj/effect/turf_decal/bot,/obj/structure/reagent_dispensers/watertank,/turf/open/floor/plasteel,/area/shuttle)
"aO" = (/obj/structure/table,/obj/item/kitchen/knife,/obj/item/kitchen/rollingpin,/turf/open/floor/plasteel/white,/area/shuttle)
"aP" = (/obj/structure/closet/secure_closet/freezer/fridge,/turf/open/floor/plasteel/white,/area/shuttle)
"aQ" = (/obj/structure/closet/wardrobe/white,/turf/open/floor/plasteel/white,/area/shuttle)
"aR" = (/obj/machinery/navbeacon{codes_txt = "patrol;next_patrol=CHW"; location = "Lockers"},/turf/open/floor/plasteel/white,/area/shuttle)
"aS" = (/obj/machinery/shower{dir = 1},/obj/item/soap/nanotrasen,/turf/open/floor/plasteel/white,/area/shuttle)
"aT" = (/obj/structure/chair/office/light{dir = 1},/turf/open/floor/plasteel/white,/area/shuttle)
"aU" = (/obj/machinery/light{dir = 8},/obj/structure/closet/crate/engineering,/obj/effect/turf_decal/bot,/turf/open/floor/plasteel,/area/shuttle)
"aV" = (/obj/effect/turf_decal/delivery,/obj/machinery/shieldgen,/turf/open/floor/plasteel/yellow,/area/shuttle)
"aW" = (/obj/structure/window/shuttle,/turf/open/floor/plasteel/white,/area/shuttle)
"aX" = (/turf/open/floor/plasteel/yellow,/area/shuttle)
"aY" = (/obj/structure/shuttle/engine/heater{dir = 8},/obj/structure/window{dir = 4},/turf/open/floor/plasteel/yellow,/area/shuttle)
"aZ" = (/obj/structure/table,/turf/open/floor/plasteel/white,/area/shuttle)
"ba" = (/obj/structure/sign/departments/restroom,/turf/closed/wall/mineral/titanium,/area/shuttle)
"bb" = (/obj/structure/rack,/obj/effect/turf_decal/bot,/obj/item/storage/toolbox/emergency,/obj/item/storage/toolbox/electrical,/obj/item/stack/sheet/plasteel,/obj/item/stack/sheet/glass,/obj/item/stack/cable_coil,/obj/item/stack/rods/fifty,/turf/open/floor/plasteel,/area/shuttle)
"bc" = (/obj/effect/turf_decal/delivery,/obj/machinery/navbeacon,/turf/open/floor/plasteel,/area/shuttle)
"bd" = (/obj/structure/closet/crate/internals,/turf/open/floor/plasteel/yellow,/area/shuttle)
"be" = (/obj/structure/table,/turf/open/floor/plasteel/darkblue,/area/shuttle)
"bf" = (/obj/machinery/computer/secure_data,/turf/open/floor/plasteel/darkblue,/area/shuttle)
"bg" = (/obj/machinery/photocopier,/turf/open/floor/plasteel/darkblue,/area/shuttle)
"bh" = (/obj/structure/table,/obj/machinery/light{dir = 1},/turf/open/floor/plasteel/darkblue,/area/shuttle)
"bi" = (/obj/structure/shuttle/engine/large{dir = 8},/turf/open/floor/plasteel/yellow,/area/shuttle)
"bj" = (/obj/machinery/smartfridge/food,/turf/open/floor/plasteel/white,/area/shuttle)
"bk" = (/obj/structure/noticeboard,/turf/closed/wall/mineral/titanium,/area/shuttle)
"bl" = (/obj/structure/table,/obj/item/reagent_containers/food/condiment/flour,/obj/item/reagent_containers/food/condiment/flour,/obj/item/reagent_containers/food/condiment/flour,/obj/item/reagent_containers/food/condiment/flour,/obj/item/reagent_containers/glass/beaker,/turf/open/floor/plasteel/white,/area/shuttle)
"bm" = (/obj/structure/rack,/obj/effect/turf_decal/bot,/obj/item/storage/box/lights/tubes,/obj/item/storage/box/metalfoam,/turf/open/floor/plasteel,/area/shuttle)
"bn" = (/obj/structure/extinguisher_cabinet{dir = 4; pixel_x = 24},/turf/open/floor/plasteel/white,/area/shuttle)
"bo" = (/turf/open/floor/plasteel/darkblue,/area/shuttle)
"bp" = (/obj/structure/chair/comfy/shuttle{dir = 1},/turf/open/floor/plasteel/darkblue,/area/shuttle)
"bq" = (/obj/structure/chair/office/light{dir = 4},/turf/open/floor/plasteel/white,/area/shuttle)
"br" = (/obj/machinery/light{dir = 4},/turf/open/floor/plasteel/blue,/area/shuttle)
"bs" = (/obj/machinery/computer/security/telescreen/entertainment,/turf/closed/wall/mineral/titanium,/area/shuttle)
"bt" = (/obj/structure/sign/departments/science,/turf/closed/wall/mineral/titanium,/area/shuttle)
"bu" = (/obj/structure/sign/departments/cargo,/turf/closed/wall/mineral/titanium,/area/shuttle)
"bv" = (/obj/structure/chair/comfy/shuttle{dir = 4},/turf/open/floor/plasteel/darkblue,/area/shuttle)
"bw" = (/obj/machinery/computer/shuttle/white_ship{dir = 8},/turf/open/floor/plasteel/darkblue,/area/shuttle)
"bx" = (/obj/machinery/navbeacon,/turf/open/floor/plasteel/yellow,/area/shuttle)
"by" = (/obj/machinery/door/airlock/shuttle,/turf/open/floor/plasteel/yellow,/area/shuttle)
"bz" = (/obj/structure/chair/comfy/shuttle{dir = 4},/turf/open/floor/plasteel/blue,/area/shuttle)
"bA" = (/obj/structure/table/glass,/obj/item/storage/fancy/donut_box,/turf/open/floor/plasteel/blue,/area/shuttle)
"bB" = (/obj/structure/table/glass,/turf/open/floor/plasteel/blue,/area/shuttle)
"bC" = (/obj/structure/chair/comfy/shuttle{dir = 8},/turf/open/floor/plasteel/blue,/area/shuttle)
"bD" = (/obj/machinery/light{dir = 1},/turf/open/floor/plasteel/blue,/area/shuttle)
"bE" = (/obj/machinery/door/airlock/command,/turf/open/floor/plasteel/white,/area/shuttle)
"bF" = (/obj/structure/table,/obj/machinery/recharger,/turf/open/floor/plasteel/darkblue,/area/shuttle)
"bG" = (/obj/machinery/light,/turf/open/floor/plasteel/blue,/area/shuttle)
"bH" = (/obj/structure/table/glass,/obj/item/reagent_containers/food/condiment/peppermill,/turf/open/floor/plasteel/blue,/area/shuttle)
"bI" = (/obj/structure/table/glass,/obj/item/reagent_containers/food/condiment/saltshaker,/turf/open/floor/plasteel/blue,/area/shuttle)
"bJ" = (/obj/machinery/navbeacon{codes_txt = "patrol;next_patrol=CHW"; location = "Lockers"},/turf/open/floor/plasteel/blue,/area/shuttle)
"bK" = (/obj/effect/landmark/start/captain,/turf/open/floor/plasteel/white,/area/shuttle)
"bL" = (/obj/structure/table,/obj/item/storage/secure/briefcase,/turf/open/floor/plasteel/darkblue,/area/shuttle)
"bM" = (/obj/machinery/door/airlock/shuttle,/turf/open/floor/sepia,/area/shuttle)
"bN" = (/obj/machinery/door/airlock/shuttle,/turf/open/floor/plasteel,/area/shuttle)
"bO" = (/obj/machinery/computer/camera_advanced/shuttle_docker/whiteship{dir = 8},/turf/open/floor/plasteel/darkblue,/area/shuttle)
"bP" = (/obj/structure/extinguisher_cabinet{dir = 4; pixel_x = 24},/obj/machinery/light{dir = 4},/obj/structure/closet/crate/bin,/turf/open/floor/plasteel/white,/area/shuttle)
"bQ" = (/obj/machinery/vending/hydronutrients,/turf/open/floor/plasteel/white,/area/shuttle)
"bR" = (/obj/machinery/vending/hydroseeds,/turf/open/floor/plasteel/white,/area/shuttle)
"bS" = (/obj/machinery/vending/coffee,/turf/open/floor/plasteel/white,/area/shuttle)
"bT" = (/obj/machinery/vending/snack,/obj/machinery/light{dir = 4},/turf/open/floor/plasteel/white,/area/shuttle)
"bU" = (/obj/structure/closet/secure_closet/personal,/turf/open/floor/sepia,/area/shuttle)
"bV" = (/turf/open/floor/sepia,/area/shuttle)
"bW" = (/obj/machinery/mech_bay_recharge_port,/obj/effect/turf_decal/bot,/turf/open/floor/plasteel/yellow,/area/shuttle)
"bX" = (/obj/mecha/working/ripley,/turf/open/floor/plasteel/recharge_floor,/area/shuttle)
"bY" = (/turf/open/floor/plasteel,/area/shuttle)
"bZ" = (/obj/structure/table,/obj/machinery/cell_charger,/turf/open/floor/plasteel,/area/shuttle)
"ca" = (/obj/structure/chair/comfy/shuttle,/turf/open/floor/plasteel/darkblue,/area/shuttle)
"cb" = (/obj/structure/table,/obj/item/gps,/obj/item/paicard,/turf/open/floor/plasteel/darkblue,/area/shuttle)
"cc" = (/obj/structure/bed/pod{dir = 6},/obj/machinery/light{dir = 8},/turf/open/floor/sepia,/area/shuttle)
"cd" = (/obj/structure/bed/pod{dir = 6},/obj/machinery/light{dir = 4},/turf/open/floor/sepia,/area/shuttle)
"ce" = (/obj/effect/turf_decal/bot,/obj/structure/closet/crate{name = "emergency supplies crate"},/turf/open/floor/plasteel,/area/shuttle)
"cf" = (/obj/machinery/light{dir = 4},/obj/machinery/mecha_part_fabricator,/turf/open/floor/plasteel,/area/shuttle)
"cg" = (/obj/structure/table,/obj/item/folder/white,/obj/item/folder/white,/obj/item/folder/white,/turf/open/floor/plasteel/darkblue,/area/shuttle)
"ch" = (/obj/structure/table,/obj/item/documents/nanotrasen,/turf/open/floor/plasteel/darkblue,/area/shuttle)
"ci" = (/obj/structure/table,/obj/item/paper_bin,/obj/item/pen,/turf/open/floor/plasteel/darkblue,/area/shuttle)
"cj" = (/obj/structure/table,/obj/machinery/light,/obj/item/storage/bag/money,/turf/open/floor/plasteel/darkblue,/area/shuttle)
"ck" = (/obj/structure/sink{dir = 8; pixel_x = -12},/turf/open/floor/plasteel/white,/area/shuttle)
"cl" = (/obj/machinery/door/airlock/security,/turf/open/floor/plasteel/blue,/area/shuttle)
"cm" = (/obj/structure/bed/pod,/turf/open/floor/sepia,/area/shuttle)
"cn" = (/obj/machinery/navbeacon{codes_txt = "patrol;next_patrol=CHW"; location = "Lockers"},/turf/open/floor/sepia,/area/shuttle)
"co" = (/obj/effect/turf_decal/loading_area{dir = 1},/turf/open/floor/plasteel/yellow/side,/area/shuttle)
"cp" = (/obj/effect/turf_decal/loading_area{dir = 1},/obj/machinery/navbeacon,/turf/open/floor/plasteel/yellow/side,/area/shuttle)
"cq" = (/obj/structure/bed/pod{dir = 2},/obj/effect/turf_decal/stripes/red/full,/turf/open/floor/plasteel/red,/area/shuttle)
"cr" = (/obj/effect/turf_decal/stripes/red/full,/obj/machinery/light{dir = 1},/turf/open/floor/plasteel/red,/area/shuttle)
"cs" = (/obj/effect/turf_decal/stripes/red/full,/turf/open/floor/plasteel/red,/area/shuttle)
"ct" = (/obj/structure/bed/pod{dir = 6},/obj/effect/turf_decal/stripes/red/full,/turf/open/floor/plasteel/red,/area/shuttle)
"cu" = (/obj/machinery/hydroponics/constructable,/turf/open/floor/plasteel/white,/area/shuttle)
"cv" = (/obj/structure/sign/departments/security,/turf/closed/wall/mineral/titanium,/area/shuttle)
"cw" = (/obj/machinery/light,/turf/open/floor/plasteel/white,/area/shuttle)
"cx" = (/obj/machinery/vending/boozeomat{icon_deny = "smartfridge"; icon_state = "smartfridge"; req_access_txt = "0"; use_power = 0},/obj/machinery/chem_dispenser/drinks{dir = 8; step_y = 26},/turf/open/floor/plasteel/white,/area/shuttle)
"cy" = (/obj/structure/bed/pod{dir = 6},/turf/open/floor/sepia,/area/shuttle)
"cz" = (/obj/machinery/light,/turf/open/floor/sepia,/area/shuttle)
"cA" = (/obj/machinery/vending/engivend,/turf/open/floor/plasteel,/area/shuttle)
"cB" = (/obj/effect/turf_decal/bot,/mob/living/simple_animal/bot/cleanbot{model = "NTExplorer Cleanbot"},/turf/open/floor/plasteel/yellow,/area/shuttle)
"cC" = (/obj/effect/turf_decal/bot,/mob/living/simple_animal/bot/medbot,/turf/open/floor/plasteel/yellow,/area/shuttle)
"cD" = (/obj/effect/turf_decal/bot,/mob/living/simple_animal/bot/secbot,/turf/open/floor/plasteel/yellow,/area/shuttle)
"cE" = (/obj/machinery/vending/tool,/turf/open/floor/plasteel,/area/shuttle)
"cF" = (/obj/effect/turf_decal/stripes/red/full,/obj/machinery/door/airlock/security,/turf/open/floor/plasteel/red,/area/shuttle)
"cG" = (/obj/machinery/door/airlock/security{name = "Brig"; req_access_txt = "63; 42"},/turf/open/floor/plasteel/blue,/area/shuttle)
"cH" = (/obj/machinery/chem_dispenser/drinks/beer{dir = 1; step_y = 25},/turf/closed/wall/mineral/titanium,/area/shuttle)
"cI" = (/obj/structure/sign/departments/medbay/alt,/turf/closed/wall/mineral/titanium,/area/shuttle)
"cJ" = (/obj/structure/closet/secure_closet/personal,/turf/open/floor/plasteel/red,/area/shuttle)
"cK" = (/turf/open/floor/plasteel/red,/area/shuttle)
"cL" = (/obj/machinery/light{dir = 1},/turf/open/floor/plasteel/red,/area/shuttle)
"cM" = (/obj/structure/rack,/obj/item/storage/box/teargas,/obj/item/storage/box/flashbangs,/turf/open/floor/plasteel/red,/area/shuttle)
"cN" = (/obj/structure/rack,/obj/item/forcefield,/turf/open/floor/plasteel/red,/area/shuttle)
"cO" = (/obj/structure/rack,/turf/open/floor/plasteel/red,/area/shuttle)
"cP" = (/obj/structure/closet/secure_closet/medical1,/turf/open/floor/plasteel/cmo,/area/shuttle)
"cQ" = (/turf/open/floor/plasteel/cmo,/area/shuttle)
"cR" = (/obj/structure/closet/secure_closet/medical3,/turf/open/floor/plasteel/cmo,/area/shuttle)
"cS" = (/obj/structure/table,/turf/open/floor/plasteel/red,/area/shuttle)
"cT" = (/obj/machinery/navbeacon,/turf/open/floor/plasteel/red,/area/shuttle)
"cU" = (/obj/machinery/light{dir = 4},/obj/effect/turf_decal/bot,/obj/structure/closet/crate,/turf/open/floor/plasteel,/area/shuttle)
"cV" = (/obj/structure/bed/roller,/turf/open/floor/plasteel/cmo,/area/shuttle)
"cW" = (/obj/machinery/iv_drip,/turf/open/floor/plasteel/cmo,/area/shuttle)
"cX" = (/obj/machinery/sleeper{dir = 8},/turf/open/floor/plasteel/cmo,/area/shuttle)
"cY" = (/obj/structure/closet/secure_closet/evidence,/turf/open/floor/plasteel/red,/area/shuttle)
"cZ" = (/obj/machinery/light,/turf/open/floor/plasteel/red,/area/shuttle)
"da" = (/obj/structure/table,/obj/machinery/recharger,/turf/open/floor/plasteel/red,/area/shuttle)
"db" = (/obj/structure/closet/secure_closet/armory3,/turf/open/floor/plasteel/red,/area/shuttle)
"dc" = (/obj/structure/closet/secure_closet/armory1,/turf/open/floor/plasteel/red,/area/shuttle)
"dd" = (/obj/structure/closet/secure_closet/security,/turf/open/floor/plasteel/red,/area/shuttle)
"de" = (/obj/structure/bodycontainer/morgue,/turf/open/floor/plasteel/cmo,/area/shuttle)
"df" = (/obj/machinery/door/airlock/shuttle,/turf/open/floor/plasteel/cmo,/area/shuttle)
"dg" = (/obj/machinery/navbeacon{codes_txt = "patrol;next_patrol=CHW"; location = "Lockers"},/turf/open/floor/plasteel/cmo,/area/shuttle)
"dh" = (/obj/machinery/light{dir = 4},/turf/open/floor/plasteel/cmo,/area/shuttle)
"di" = (/obj/machinery/vending/medical,/turf/open/floor/plasteel/cmo,/area/shuttle)
"dj" = (/obj/structure/table,/obj/machinery/light,/obj/item/storage/box/bodybags,/obj/item/storage/box/gloves,/obj/item/storage/box/masks,/obj/item/storage/box/medsprays,/obj/item/storage/box/pillbottles,/obj/item/storage/box/syringes,/turf/open/floor/plasteel/cmo,/area/shuttle)
"dk" = (/obj/structure/table,/obj/item/storage/firstaid/toxin,/obj/item/storage/firstaid/regular,/obj/item/storage/firstaid/o2,/obj/item/storage/firstaid/fire,/obj/item/storage/firstaid/brute,/turf/open/floor/plasteel/cmo,/area/shuttle)
"dl" = (/obj/machinery/light{dir = 8},/obj/effect/turf_decal/bot,/obj/effect/turf_decal/delivery,/obj/machinery/portable_atmospherics/canister/air,/turf/open/floor/plasteel/white,/area/shuttle)
"dm" = (/obj/machinery/space_heater,/obj/effect/turf_decal/delivery,/turf/open/floor/plasteel/yellow,/area/shuttle)
"dn" = (/obj/effect/turf_decal/delivery,/obj/machinery/portable_atmospherics/canister/air,/turf/open/floor/plasteel/yellow,/area/shuttle)
"do" = (/obj/structure/closet/radiation,/turf/open/floor/plasteel/yellow,/area/shuttle)
"dp" = (/obj/machinery/light{dir = 4},/turf/open/floor/plasteel/yellow,/area/shuttle)
"dq" = (/obj/machinery/space_heater,/obj/effect/turf_decal/delivery,/obj/machinery/light,/turf/open/floor/plasteel/yellow,/area/shuttle)
"dr" = (/obj/structure/rack,/obj/item/storage/toolbox/electrical,/turf/open/floor/plasteel/yellow,/area/shuttle)
"ds" = (/obj/structure/rack,/obj/item/storage/toolbox/emergency,/obj/item/storage/toolbox/mechanical{step_y = 29},/turf/open/floor/plasteel/yellow,/area/shuttle)
"dt" = (/obj/machinery/vending/dinnerware,/turf/open/floor/plasteel/white,/area/shuttle)
"du" = (/obj/structure/table,/obj/item/cultivator,/obj/item/reagent_containers/glass/bucket,/turf/open/floor/plasteel/white,/area/shuttle)
"dv" = (/obj/structure/closet/emcloset,/turf/open/floor/plasteel/yellow,/area/shuttle)
"dw" = (/obj/structure/closet/emcloset,/turf/open/floor/plasteel/white,/area/shuttle)
"dx" = (/obj/structure/table,/obj/machinery/light{dir = 8},/turf/open/floor/plasteel/white,/area/shuttle)
"dy" = (/obj/structure/closet/emcloset,/turf/open/floor/plasteel/red,/area/shuttle)
"dz" = (/obj/machinery/light{dir = 1},/obj/structure/table,/turf/open/floor/plasteel/white,/area/shuttle)
"dA" = (/obj/machinery/light{dir = 8},/obj/machinery/autolathe,/turf/open/floor/plasteel,/area/shuttle)
"dB" = (/obj/structure/table,/obj/item/folder/documents,/obj/item/paper,/turf/open/floor/plasteel/darkblue,/area/shuttle)
"dC" = (/obj/effect/turf_decal/bot,/obj/structure/closet/crate,/turf/open/floor/plasteel,/area/shuttle)
"dD" = (/obj/machinery/light{dir = 8},/obj/structure/closet/crate/medical,/turf/open/floor/plasteel/cmo,/area/shuttle)
"dE" = (/obj/machinery/light{dir = 1},/obj/structure/closet/radiation,/turf/open/floor/plasteel/yellow,/area/shuttle)
"dF" = (/obj/structure/closet/l3closet,/turf/open/floor/plasteel/yellow,/area/shuttle)
"dG" = (/obj/structure/closet/crate/radiation,/turf/open/floor/plasteel/yellow,/area/shuttle)

(1,1,1) = {"
aaaaaaaaaaaaaaaaaaaaaaaaaaaaaaaaaaaaaaaaaaaaaaaaaaaaaaaaaaaaaaaaaaaaaaaaaaaaaaaaaaaaaaaaaaaaaaabacadaeacabababababaaaaaa
aaaaaaaaaaaaaaaaaaaaaaaaaaabababababababababababababababaaaaaaaaaaaaaaaaaaaaaaaaaaaaaaaaaaaaaaabafagagahabaiajakabaaaaaa
aaaaaaaaaaaaaaaaaaaaaaaaaaabdvdodEbdaVaVaVabbqdzaJbqaZababaaaaaaaaaaaaaaaaaaaaaaaaaaaaaaaaaaaaalafamamamanaoapaqabaaaaaa
aaaaaaaaaaaaaaaaaaaaaaaaaaabdFaXaXaXaXbxaXbyamamamamamamababaaaaaaaaaaaaaaaaaaaaaaaaaaaaaaaaaaabafamamafataiauakabaaaaaa
aaaaaaaaaaaaaaaaaaaaaaaaaaabdraXdGaXaXaXdpabbqaZbqaZbGamamabaaaaaaaaaaaaaaaaaaaaaaaaaaaaaaaaaaabdlamamdwabababababaaaaaa
aaaaaaaaaaaaaaaaaaaaaaaaaaabdsaXaXaXaXaXaXalabababababananabababababababababababababababababababaxananaxabaaaaaaaaaaaaaa
aaaaaaaaaaaaaaaaaaaaaaaaaaabaXdmdqdndndndnabayawafazabaAamabaBaCaDafaEaFabaGaHaIaJabaKaLceaMaNabafamamafabaaaaaaaaaaaaaa
aaaaaaaaaaaaaaaaaaaaaaaaaaabababababababababaOarafaPabamamabaQafafaRabaSabafaTafafabaUaoaoaocUabafamamafababaWababababab
aaaaaaaaaaaaaaaaaaaaaaaaaaaaaaaXaXaYaXaXaXabblafafafasamamababbaasasbaababavafaRahabbbaobcaodCabavamamahabbebfbebgbhbeaW
aaaaaaaaaaaaaaaaaaaaaaaaaaaaaabiaXaYaXaXdpabckcwdtbjabamambkdwafamamafbPabafafafafabbmaoaoaodCabdwamambnabbobpbobobodBaW
aaaaaaaaaaaaaaaaaaaaaaaaaaaaaaaXaXaYaXaXaXababababababambrbsafamamamamafabbtasasbtababbuasbuababafamamafabavafafafbvbwaW
aaaaaaaaaaaaaaaaaaaaaaaaaaaaaabiaXaYbxaXaXbyamamanamamamamanambzbAbBbCamamamamamambDamamamamamanamamamambEafafafafbobFaW
aaaaaaaaaaaaaaaaaaaaaaaaaaaaaaaXaXaYaXaXaXbyambGanamamamamanambzbHbIbCamambGamamamamamamambGamanambJamambEafbKaRafbobLaW
aaaaaaaaaaaaaaaaaaaaaaaaaaaaaabiaXaYaXaXaXababababalabamamabafamamamamafabbabMbMbaabababbNabababafamamafabavafafafbvbOaW
aaaaaaaaaaaaaaaaaaaaaaaaaaaaaaaXaXaYaXaXdpabdubQbRbjabamamabbSafamamafbTabbUbVbVbUabbWbXbYbYbZabafamamafbkbocabobobocbaW
aaaaaaaaaaaaaaaaaaaaaaaaaaaaaabiaXaYaXaXaXabavafafafasambrabababasasabababccbVbVcdabdAbYbYbYcfabavamamahabcgchcibecjbeaW
aaaaaaaaaaaaaaaaaaaaaaaaaaabababababababababckarafahabclclabdxafafaRafafabcmbVcncmabbYcocpcobYabafamamafababaWababababab
aaaaaaaaaaaaaaaaaaaaaaaaaaabcqcrcsabcscrctabcucucucucvambrcvaZafafafcwcxabcyczbVcmabcAcBcCcDcEabafamamafabaaaaaaaaaaaaaa
aaaaaaaaaaaaaaaaaaaaaaaaaaabababcFabcFababababababababcGcGababcHababababababababababababababababcIanancIabaaaaaaaaaaaaaa
aaaaaaaaaaaaaaaaaaaaaaaaaaabcJcKcKcKcKcLcKcMcNcOcKcKcLcKcKabaaaaaaaaaaaaaaaaaaaaaaaaaaaaaaaaaaabcPcQcQcRabababababaaaaaa
aaaaaaaaaaaaaaaaaaaaaaaaaaabcJcKcKcScKcTcKcKcKcKcKcKcKdyababaaaaaaaaaaaaaaaaaaaaaaaaaaaaaaaaaaabdDcQcQcQabcVcWcXabaaaaaa
aaaaaaaaaaaaaaaaaaaaaaaaaaabcYcZdacSdacKdbdccZddddddddababaaaaaaaaaaaaaaaaaaaaaaaaaaaaaaaaaaaaabdecQcQcQdfcQdgdhabaaaaaa
aaaaaaaaaaaaaaaaaaaaaaaaaaabababababababababababababababaaaaaaaaaaaaaaaaaaaaaaaaaaaaaaaaaaaaaaabdicQdjdkabcVcWcXabaaaaaa
aaaaaaaaaaaaaaaaaaaaaaaaaaaaaaaaaaaaaaaaaaaaaaaaaaaaaaaaaaaaaaaaaaaaaaaaaaaaaaaaaaaaaaaaaaaaaaababababababababababaaaaaa
aaaaaaaaaaaaaaaaaaaaaaaaaaaaaaaaaaaaaaaaaaaaaaaaaaaaaaaaaaaaaaaaaaaaaaaaaaaaaaaaaaaaaaaaaaaaaaaaaaaaaaaaaaaaaaaaaaaaaaaa
aaaaaaaaaaaaaaaaaaaaaaaaaaaaaaaaaaaaaaaaaaaaaaaaaaaaaaaaaaaaaaaaaaaaaaaaaaaaaaaaaaaaaaaaaaaaaaaaaaaaaaaaaaaaaaaaaaaaaaaa
aaaaaaaaaaaaaaaaaaaaaaaaaaaaaaaaaaaaaaaaaaaaaaaaaaaaaaaaaaaaaaaaaaaaaaaaaaaaaaaaaaaaaaaaaaaaaaaaaaaaaaaaaaaaaaaaaaaaaaaa
aaaaaaaaaaaaaaaaaaaaaaaaaaaaaaaaaaaaaaaaaaaaaaaaaaaaaaaaaaaaaaaaaaaaaaaaaaaaaaaaaaaaaaaaaaaaaaaaaaaaaaaaaaaaaaaaaaaaaaaa
aaaaaaaaaaaaaaaaaaaaaaaaaaaaaaaaaaaaaaaaaaaaaaaaaaaaaaaaaaaaaaaaaaaaaaaaaaaaaaaaaaaaaaaaaaaaaaaaaaaaaaaaaaaaaaaaaaaaaaaa
aaaaaaaaaaaaaaaaaaaaaaaaaaaaaaaaaaaaaaaaaaaaaaaaaaaaaaaaaaaaaaaaaaaaaaaaaaaaaaaaaaaaaaaaaaaaaaaaaaaaaaaaaaaaaaaaaaaaaaaa
aaaaaaaaaaaaaaaaaaaaaaaaaaaaaaaaaaaaaaaaaaaaaaaaaaaaaaaaaaaaaaaaaaaaaaaaaaaaaaaaaaaaaaaaaaaaaaaaaaaaaaaaaaaaaaaaaaaaaaaa
aaaaaaaaaaaaaaaaaaaaaaaaaaaaaaaaaaaaaaaaaaaaaaaaaaaaaaaaaaaaaaaaaaaaaaaaaaaaaaaaaaaaaaaaaaaaaaaaaaaaaaaaaaaaaaaaaaaaaaaa
aaaaaaaaaaaaaaaaaaaaaaaaaaaaaaaaaaaaaaaaaaaaaaaaaaaaaaaaaaaaaaaaaaaaaaaaaaaaaaaaaaaaaaaaaaaaaaaaaaaaaaaaaaaaaaaaaaaaaaaa
aaaaaaaaaaaaaaaaaaaaaaaaaaaaaaaaaaaaaaaaaaaaaaaaaaaaaaaaaaaaaaaaaaaaaaaaaaaaaaaaaaaaaaaaaaaaaaaaaaaaaaaaaaaaaaaaaaaaaaaa
aaaaaaaaaaaaaaaaaaaaaaaaaaaaaaaaaaaaaaaaaaaaaaaaaaaaaaaaaaaaaaaaaaaaaaaaaaaaaaaaaaaaaaaaaaaaaaaaaaaaaaaaaaaaaaaaaaaaaaaa
aaaaaaaaaaaaaaaaaaaaaaaaaaaaaaaaaaaaaaaaaaaaaaaaaaaaaaaaaaaaaaaaaaaaaaaaaaaaaaaaaaaaaaaaaaaaaaaaaaaaaaaaaaaaaaaaaaaaaaaa
aaaaaaaaaaaaaaaaaaaaaaaaaaaaaaaaaaaaaaaaaaaaaaaaaaaaaaaaaaaaaaaaaaaaaaaaaaaaaaaaaaaaaaaaaaaaaaaaaaaaaaaaaaaaaaaaaaaaaaaa
aaaaaaaaaaaaaaaaaaaaaaaaaaaaaaaaaaaaaaaaaaaaaaaaaaaaaaaaaaaaaaaaaaaaaaaaaaaaaaaaaaaaaaaaaaaaaaaaaaaaaaaaaaaaaaaaaaaaaaaa
aaaaaaaaaaaaaaaaaaaaaaaaaaaaaaaaaaaaaaaaaaaaaaaaaaaaaaaaaaaaaaaaaaaaaaaaaaaaaaaaaaaaaaaaaaaaaaaaaaaaaaaaaaaaaaaaaaaaaaaa
aaaaaaaaaaaaaaaaaaaaaaaaaaaaaaaaaaaaaaaaaaaaaaaaaaaaaaaaaaaaaaaaaaaaaaaaaaaaaaaaaaaaaaaaaaaaaaaaaaaaaaaaaaaaaaaaaaaaaaaa
"}
